WE ./assets/textures/japan-wall-shoji-top.xpm
EA ./assets/textures/japan-wall-shoji-top-2.xpm
NO ./assets/textures/japan-wall-shoji-wall-2.xpm
SO ./assets/textures/japan-wall-shoji-wall.xpm

C 136, 219, 223
F 110, 98, 89

11111111111111111111111111111111111111111111111111111
10000011100000011000000111000000000000000000000000001
11110111101111011011110111111111111111111211111111121
10000111100000011000000111100000000000000000000000001
10110111110111011011110111121111111111111111121111121
1111211111211121121111211110111111111       101   101
1000000000000000000000000000000000011       101   1011
11211111111121111111111111111111112111111111101   1001
11000000000000000000000000000000000000000000001   1101
11111111111111111111111111011111111011111111101    101
                         101      101       101    101
                         101      101       101    101
                         101      101       101    101
                         101      101       101    101
                         101      101       101    101
                         1211111111211111111121    101
                         1000000000000000000001    101
                         1111110111111110111111    101
                              101      101         101
                              101      101         101
                              101      101         101
                              101      101         101
                              101      101         101
                              1211111111211111111111211111
                              1000000000000000000002000041
                              111111111111111111111100W001
                                                   1400041
                                                   1111111 