WE ./assets/textures/stone-wall-mossy.xpm
EA ./assets/textures/stone-wall.xpm
NO ./assets/textures/stone-wall-cracked.xpm
SO ./assets/textures/stone-wall.xpm

C 98, 181, 229
F 110, 98, 89

11111111111111111111111111111111111111111111111111111
1E000411100000011000000111000000000000000000000000001
10000411100000011000000111000000000000000000000000001
11110011100110011001100111001111111111111111111110001
1111321110011001100110011100111111111           11011
1100000000000000000000000000000000011            101
1140000000000000000000000000000000011             1
1111111111111111111111111111111111111
