NO ./assets/textures/test-north.xpm  
 
SO     ./assets/textures/test-south.xpm    

F  205, 133, 63




 EA ./assets/textures/test-east.xpm
WE     ./assets/textures/test-west.xpm


C 135, 206, 235




  
   

    
        11111111111111111
        10000000000000001
1111111100000000001111111
10000001000001E1000000001
1011111110001000100000001
1000000000110000010000011
1111111111111111111111111
