NO ./assets/textures/test-north.xpm  
 
SO     ./assets/textures/test-south.xpm    

F  205, 133, 63




 EA ./assets/textures/test-east.xpm
WE     ./assets/textures/test-west.xpm


C 135, 206, 235




  
   

    
        11111111111111111111111111111111111111111111111111111111111111111111111
        1000000000000000000000000000000000000000000000000000000000000000000011111
        1000000000111111111111100000000000000000000001100000001111111111111111111
        1000000000000000000000000000000000000000000011111000000000000111111111111
1111111110000000000000000000000001111111111111111111111111111111111111111111111111
100000000011000001110000000000110000000000000011000000000000001100000111111111111
10001111111110111000111110000000000000000000000000000000000000000000011111111111
100001011111111101110100000000000000000000000001111111111111111111111111111111
11000000110101000000000000000000000000000000001111111111111111111111  11111111
1111000000000000000000000000000000000000000000011111111111111111111111111111
111100000000001011101010000000000000N000000000000000000000000000000000000011
1100000011010101110000001000000000000000000000000000111111111111111111111111
1111011111111101110000001000000000000000000000000000000011111111111111111111
1111011111111101110101001000000000000000000000000000000011111111111111111111
1100000011010101110000000000000000000000000000001110011111111111111111111111
111101111111110111000000100000000000001111111111100000000000000000000000011
11110111111111011101010010000000001111111000000000000000000000000011111111
110000001101010111000000100000011111100000000000000000000000001111111111
10000000000000001100000010000011111000000000000000000000000011111111111
1000000000000000110101001000011111000000000000000000000000011111111111
11000001110101011111011110001111110000000000000000000000000111111111111
11110111 1110101 10111101000111100000000000000000000000001111111111111111
11111111 1111111 11111111111111111111111111111111111111111111111111111111111
