NO assets/textures/japan-wall-shoji-top.xpm

SO  assets/textures/japan-wall-shoji-top.xpm

F  0010,1,4




 EA assets/textures/japan-wall-shoji-top.xpm
WE     assets/textures/japan-wall-shoji-top.xpm


C 0,0,1

11111
110N1
11111
